##########################
#........................#
#............#...........#
#............@...........#
#........................#
###########.##############
###########.##############
#........................#
#............#...........#
#........................#
#........................#
##############.###########
##############.###########
#........................#
#............#...........#
#........................#
#........................#
##########################