############
#..........#
#....####..#
#.....#....#
#..#....#..#
#.##.@..#..#
#.......#..#
#####..##.##
#..........#
#...##.#...#
#...#..#...#
#####.######
############